{
    "id": "restaurant",
    "nb_players": 10,
    "map": {
        "size": {
            "width": 740,
            "height": 510
        },
        "startPosition": {
            "x": 520,
            "y": 280
        },
        "tileWidth": 20,
        "tileHeight": 20,
        "tilesOffset": {
            "x": 480,
            "y": 120
        },
        "tiles":[
            [1, 1, 1, 1, 1, 1, 1, 1, 1, 1, 1, 0, 0],
            [1, 1, 1, 1, 1, 1, 1, 1, 1, 1, 1, 0, 0],
            [1, 1, 1, 1, 1, 1, 1, 1, 1, 1, 1, 0, 0],
            [1, 1, 1, 0, 0, 0, 0, 0, 0, 0, 0, 0, 0],
            [1, 1, 1, 0, 0, 0, 0, 0, 0, 0, 0, 0, 0],
            [1, 1, 1, 0, 0, 0, 0, 0, 1, 1, 1, 1, 1],
            [0, 0, 0, 0, 0, 0, 1, 1, 1, 1, 1, 1, 1],
            [0, 0, 0, 0, 0, 0, 1, 1, 1, 1, 1, 1, 1],
            [0, 1, 1, 1, 1, 1, 1, 1, 1, 1, 1, 1, 1],
            [0, 1, 1, 1, 0, 1, 1, 1, 1, 1, 1, 1, 1],
            [0, 1, 1, 1, 0, 1, 1, 1, 1, 1, 1, 1, 1],
            [0, 1, 1, 1, 0, 1, 1, 1, 1, 1, 1, 1, 1],
            [0, 1, 1, 1, 0, 1, 1, 1, 1, 1, 1, 1, 1],
            [0, 1, 1, 1, 0, 1, 1, 1, 1, 1, 1, 1, 1],
            [0, 1, 1, 1, 0, 1, 1, 1, 1, 1, 1, 1, 1],
            [0, 0, 0, 0, 0, 1, 1, 1, 1, 1, 1, 1, 1],
            [0, 1, 1, 1, 1, 1, 1, 1, 1, 1, 1, 1, 1],
            [0, 1, 1, 1, 1, 1, 1, 1, 1, 1, 1, 1, 1],
            [0, 1, 1, 1, 1, 1, 1, 1, 1, 1, 1, 1, 1],
            [0, 1, 1, 1, 1, 1, 1, 1, 1, 1, 1, 1, 1],
            [0, 1, 1, 1, 1, 1, 1, 1, 1, 1, 1, 1, 1],
            [0, 1, 1, 1, 1, 1, 1, 1, 1, 1, 1, 1, 1],
            [0, 1, 1, 1, 1, 1, 1, 1, 1, 1, 1, 1, 1],
            [0, 1, 1, 1, 1, 1, 1, 1, 1, 1, 1, 1, 1]
        ],
        "background": {
            "restaurant": {
                "img": "restaurant.png"
            }
        },
        "foreground": {
            "bar": {
                "img": "bar.png",
                "offset": {
                    "x": 177,
                    "y": 217
                }
            }
        }
    }
}
